1	7

2	2	2	2	2	2	2	2	2	2	2	2			
2	4	4	4	4	4	4	4	4	4	4	2			
2	0	0	0	0	0	0	0	0	0	0	2		
2	0	0	0	0	0	0	0	0	1	0	2		
2	0	0	0	0	0	0	0	2	2	2	2		
2	0	0	0	0	0	0	2	2	2	2	2			
2	0	2	0	0	0	2	2	3	2	2	2			
2	0	2	0	0	2	2	2	2	2	2	2				
2	2	2	0	2	2	2	2	2	2	2	2			
