1	7

2	2	2	2	2	2	2	2	2	2	2	2			
2	0	0	0	0	0	0	0	0	0	0	2			
2	0	0	0	0	0	0	0	0	0	0	2		
2	0	0	0	0	0	0	0	0	0	0	2		
2	0	0	0	0	0	0	0	5	0	1	2		
2	0	0	0	0	0	0	2	2	2	2	2			
2	0	0	2	5	2	0	0	0	0	0	2			
2	0	0	0	0	0	0	0	0	0	0	2				
2	2	2	0	0	0	0	0	0	0	0	2			
